2
10
15
000001111110000
000001001110000
000001001111100
S11111000001111
0000111000011G1
000011100000111
000000100110000
000000111110000
000000111110000
000000011100000